# #######
#   #   #
# ### # #
# #   # #
# # # ###
#   # # #
# ### # #
#   #   #
####### #