W WWWWWWW
W   W   W
W WWW W W
W W   W W
W W W WWW
W   W W W
W WWW W W
W   W   W
WWWWWWW W